15 15 15 8 15 15 15 8 15 15 15 15 15 
15 0 15 8 15 15 15 0 15 0 15 0 15 
15 0 15 15 15 15 0 0 15 0 8 0 15 
15 15 15 0 15 15 15 15 15 8 15 15 15 
6 15 15 0 15 15 8 15 15 0 6 0 8 
6 6 15 15 15 0 15 15 8 15 6 15 15 
15 0 0 0 6 6 6 8 15 15 6 0 15 
15 15 15 8 6 0 15 0 15 0 15 0 15 
8 0 15 8 15 0 0 0 15 15 15 0 15 
15 0 15 0 15 0 0 0 15 0 8 0 15 
15 0 15 0 15 1 1 1 15 15 15 15 15 
15 0 15 15 15 3 3 3 15 0 15 0 15 
15 0 15 0 15 0 13 0 15 0 0 0 15 
