15 15 15 15 15 15 15 15 15 15 15 15 15 
15 0 15 0 15 0 15 0 15 0 15 0 15 
15 0 15 0 15 0 11 0 15 0 15 0 15 
15 0 15 0 15 0 9 0 15 0 15 0 15 
15 0 15 0 15 15 15 15 15 0 15 0 15 
15 15 15 15 15 0 15 0 15 15 15 15 15 
11 15 0 0 15 15 15 15 15 0 0 15 11 
15 15 15 15 15 0 3 0 15 15 15 15 15 
15 0 15 0 15 0 1 0 15 0 15 0 15 
15 0 15 0 15 0 15 0 15 0 15 0 15 
15 0 15 0 15 1 15 1 15 0 15 0 15 
15 0 15 0 15 3 3 3 15 0 15 0 15 
15 15 15 15 15 0 13 0 15 15 15 15 15 
