15 15 15 15 0 15 15 15 0 15 15 15 15 
15 6 6 6 0 15 15 15 15 15 11 11 11 
0 6 6 6 15 15 15 15 15 15 15 15 15 
6 6 6 6 15 15 15 0 15 0 0 0 2 
6 6 6 6 0 0 0 1 15 0 15 2 15 
6 6 6 6 15 15 0 15 15 15 15 2 15 
15 6 15 15 15 15 8 8 8 15 15 6 15 
15 3 15 3 15 15 15 15 15 6 6 6 6 
0 2 4 0 2 4 1 1 1 6 6 6 6 
15 15 15 15 15 0 15 3 3 6 6 6 6 
0 15 15 10 15 15 15 1 1 6 6 6 15 
0 0 15 10 15 3 3 3 15 6 6 6 15 
8 0 0 15 15 0 13 0 15 0 15 15 15 
